000000000000001111111111111111111111
010000001111111111111111111111111111
000111110000001111111111111111111111
000111110000001111111111111111111111
000011100000001111111111111111111111
000111111111111111111111111111111111
001111111110001111111111111111111111
001111100000001111111111111111111111
001000100000001111111111111111111111
001000111111111111111111111111111111
000000001000001111111111111111111111
000100111000001111111111111111111111
001111100000001111111111111111111111
000001111111111111111111111111111111
000000100000001111111111111111111111