00000000000000
01000000111000
00011111000000
00011111000000
00001110000000
00011111110000
00111111111000
00111110000000
00100010000000
00100011110000
00000000100000
00010011100000
00111110000000
00000111000000
00000010000000